#####################################################
#....<.......aa.....................................#
#.....................................###...........#
#...........>..........................#............#
#..$.....###########.....**............#............#
#.....$..#M.....*......................#............#
#........#.M....*.....................###...........#
#####################################################
