#####################################################
#...................................................#
#.....................................#####.........#
#...........<.............>............#.#..........#
#......................................#.#..........#
#......................................#.#..........#
#.....................................#####.........#
#...................................................#
#...................................................#
#...................................................#
#...................................................#
#...................................................#
#...................................................#
#...................................................#
#...................................................#
#####################################################