#####################################################
#...................................................#
#......................................#.#.#........#
#.........................<............#.#.#........#
#......................................#.#.#........#
#......................................#.#.#........#
#......................................#.#.#........#
#...................................................#
#...................................................#
#...................................................#
#...................................................#
#...................................................#
#...............#####...............................#
#...............#.>.#...............................#
#...............#...................................#
#####################################################
